        W        
 WW WWW W WWW WW 
 WW WWW W WWW WW 
                 
 WW W WWWWW W WW 
    W   W   W    
WWW WWW W WWW WWW
WWW W       W WWW
      WW WW
WWW W W   W W WWW
WWW W WWWWW W WWW
    W       W    
 WW W WWWWW W WW 
        W        
 WW WWW W WWW WW 
 WW WWW   WWW WW 
        W        
