........W........
.WW.WWW.W.WWW.WW.
.WW.WWW.W.WWW.WW.
.................
.WW.W.WWWWW.W.WW.
....W...W...W....
WWW.WWW.W.WWW.WWW
WWW.W       W.WWW
   .  WWRWW  .   
WWW.W WTSOW W.WWW
WWW.W WWWWW W.WWW
....W...P...W....
.WW.W.WWWWW.W.WW.
........W........
.WW.WWW.W.WWW.WW.
.WW.WWW...WWW.WW.
........W........
